about: about auto bat boat but out tab tub 
other: her hero hot other the toe 
their: her hire hit the their tie tier tire 
there: her here tee the there three tree 
first: first fist fit fits its sir sit
would: duo loud low old would 
these: see set she sheet tee the these 
state: ate east eat sat sea seat set state taste tea test 
email: aim email lie lime mail male meal mile 
world: lord low old rod row word world 
after: after are art ate ear eat era far fare fat fate fear feat rat rate ref tar tea tear 
video: die dive doe video void 
links: ink ins link links nil silk sin sink ski skin 
years: are aye ear ears easy era ray rays say sea yea year years yes
items: item items its met set sit site stem tie ties time times 
group: group our pour pro rug 
under: den due end red run under 
games: age ages game games gas gem mesa sage same sea 
could: cloud cod cold could doc duo loud old 
great: age are art ate ear eat era gate gear get great rage rat rate tag tar tea tear 
hotel: hole hot hotel let lot the toe 
store: res rest rose set sort store toe 
terms: met res rest set stem term terms 
local: all call coal local 
those: hose host hot set she shoe shot the those toe 
using: gun guns ins sign sin sing sun using 
phone: hop hope one open pen phone 
forum: for form forum four from fur our 
based: abs ads bad base based beads bed beds sad sea 
black: back black cab lab lack 
index: den die end index 
being: begin being big bin 
women: men new now one own women won 
south: host hot out shot shut south thus 
pages: age ages gap gaps gas page pages pas peas sage sap sea spa 
found: don found fun fund undo 
house: hose house she shoe sue use 
photo: hop hot opt photo pot too top 
power: per power pro rope row 
three: her here tee the there three tree 
total: alot alto lot total 
place: ace cap cape lace lap pace pal pale place 
think: hint hit ink kit knit thin think tin 
north: horn hot nor north not ton 
posts: opt post posts pot spot spots stop stops top tops 
media: aid aim aimed dam dame die dim idea mad made med media mid 
water: are art ate ear eat era rat rate raw tar tea tear war ware water wear wet 
board: bad bar board bra broad road rob rod 
white: hit the tie wet white wit with 
hours: hour hours our ours rush 
